TILEMAP
192 12 							-- Size of tile map in tiles
16 16 							-- Tile size & block size
images/tiled16.png 	-- Tilesheet
24 24 								-- Number of tiles in tilesheet
  0   0   0   0   0   0   0   0   0   0   0   0   0   0   0   0   0   0   0   0   0   0   0   0   0   0   0   0   0   0   0   0   0   0   0   0   0   0   0   0   0   0   0   0   0   0   0   0   0   0   0   0   0   0   0   0   0   0   0   0   0   0   0   0   0   0   0   0   0   0   0 7 8 9 10 11 12   0 14 16 16 15 16 17 18 21 22 23 24 25 26 27 28 29 30 31 32 33 34 35 36 37 38 39 40 41 42 31 31 43 44 45 46 28 29 30 37 38 21 22 23 51 47 48 54 48 48 30 31 32 33 110 111 24 25 26 27 37 38 60 61 62 63 64 65 66 67 68 69 37 38 54 37 38 21 22 23 51 47 48 30 31 32 18 47 48 18 13 14 75 22 23 76 25 26 77 78 79   0   0   0   0   0   0   0   0   0   0   0   0   0   0 
  0   0   0   0   0   0   0   0   0   0   0   0   0   0   0   0   0   0   0   0   0   0   0   0   0   0   0   0   0   0   0   0   0   0   0   0   0   0   0   0   0   0   0   0   0   0   0   0   0   0   0   0   0   0   0   0   0   0   0   0   0   0   0   0   0   0   0   0   0   0   0 100 101 408 409 410 411   0   0   0   0   0   0   0   0 113 114 115 116 117 118 119   0   0   0   0   0   0   0   0   0   0   0 121 122 123   0   0   0   0 124 125 126   0   0   0   0   0 113 114 115 188   0   0   0   0   0   0   0   0   0   0   0 131 117 118 119   0   0   0 133 134 135 136 137 138 139 140 141   0   0   0   0   0 113 114 115 188   0   0   0   0   0   0   0   0   0   0   0 143 144 145 146 117 118 147   0   0   0   0   0   0   0   0   0   0   0   0   0   0   0   0 
  0   0   0   0   0   0   0   0   0   0   0   0   0   0   0   0   0   0   0   0   0   0   0   0   0   0   0   0   0   0   0   0   0   0   0   0   0   0   0   0   0   0   0   0   0   0   0   0   0   0   0   0   0   0   0   0   0   0   0   0   0   0   0   0   0   0   0   0   0   0   0 165 325 371 372 373 374   0   0   0   0   0   0   0   0   0 0   0   185 186 187 188   0   0   0   0   0   0   0   0   0   0   0   0   0   0   0   0   0   0   0   0   0   0   0   0   0   0   0   0   0   0   0   0   0   0   0   0   0   0   0   0   0 185 186 187 188   0   0   0 189 190 191   0 193 194 195 196 197   0   0   0   0   0   0   0   0   0   0   0   0   0   0   0   0   0   0   0   0   0   0   0 199 200 145 201   0   0   0   0   0   0   0   0   0   0   0   0   0   0   0   0 
  0   0   0   0   0   0   0   0   0   0   0   0   0   0   0   0   0   0   0   0   0   0   0   0   0   0   0   0   0   0   0   0   0   0   0   0   0   0   0   0   0   0   0   0   0   0   0   0   0   0   0   0   0   0   0   0   0   0   0   0   0   0   0   0   0   0   0   0   0   0   0 214 215 408 409 410 1   0   0   0   0   0   0   0   0   0   0   0   0   0   0   0   0   0   0   0   0   0   0   0   0   0   0   0   0   0   0   0   0   0   0   0   0   0   0   0   0   0   0   0   0   0   0   0   0   0   0   0   0   0   0   0   0   0   0   0   0   0   0 230 231 232 233 234 235 236 237 238 239   0   0   0   0   0   0   0   0   0   0   0   0   0   0   0   0   0   0   0   0   0   0   0   0   0   0   0   0   0   0   0   0   0   0   0   0   0   0   0   0   0   0   0 
  0   0   0   0   0   0   0   0   0   0   0   0   0   0   0   0   0   0   0   0   0   0   0   0   0   0   0   0   0   0   0   0   0   0   0   0   0   0   0   0   0   0   0   0   0   0   0   0   0   0   0   0   0   0   0   0   0   0   0   0   0   0   0   0   0   0   0   0   0   0   0 266 267 268 269 270 1   0   0   0   0   0   0   0   0   0   0   0   0   0   0   0   0   0   0   0   0   0   0   0   0   0   0   0   0   0   0   0   0   0   0   0   0   0   0   0   0   0   0   0   0   0   0   0   0   0   0   0   0   0   0   0   0   0   0   0   0   0   0 280 281 282 283 284 285 286 287 288   0   0   0   0   0   0   0   0   0   0   0   0   0   0   0   0   0   0   0   0   0   0   0   0   0   0   0   0   0   0   0   0   0   0   0   0   0   0   0   0   0   0   0   0 
  0   0   0   0   0   0   0   0   0   0   0   0   0   0   0   0   0   0   0   0   0   0   0   0   0   0   0   0   0   0   0   0   0   0   0   0   0   0   0   0   0   0   0   0   0   0   0   0   0   0   0   0   0   0   0   0   0   0   0   0   0   0   0   0   0   0   0   0   0   0   0   0   0   0   0   0   0   0   0   0   0   0   0   0   0   0   0   0   0   0   0   0   0   0   0   0   0   0   0   0   0   0   0   0   0   0   0   0   0   0   0   0   0   0   0   0   0   0   0   0   0   0   0   0   0   0   0   0   0   0   0   0   0   0   0   0   0   0   0   0   0   0   0   0   0   0   0   0   0   0   0   0   0   0   0   0   0   0   0   0   0   0   0   0   0   0   0   0   0   0   0   0   0   0   0   0   0   0   0   0   0   0   0   0   0   0   0   0   0   0   0   0 
  0   0   0   0   0   0   0   0   0   0   0   0   0   0   0   0   0   0   0   0   0   0   0   0   0   0   0   0   0   0   0   0   0   0   0   0   0   0   0   0   0   0   0   0   0   0   0   0   0   0   0   0   0   0   0   0   0   0   0   0   0   0   0   0   0   0   0   0   0   0   0   0   0   0   0   0   0   0   0   0   0   0   0   0   0   0   0   0   0   0   0   0   0   0   0   0   0   0   0   0   0   0   0   0   0   0   0   0   0   0   0   0   0   0   0   0   0   0   0   0   0   0   0   0   0   0   0   0   0   0   0   0   0   0   0   0   0   0   0   0   0   0   0   0   0   0   0   0   0   0   0   0   0   0   0   0   0   0   0   0   0   0   0   0   0   0   0   0   0   0   0   0   0   0   0   0   0   0   0   0   0   0   0   0   0   0   0   0   0   0   0   0 
  0   0   0   0   0   0   0   0   0   0   0   0   0   0   0   0   0   0   0   0   0   0   0   0   0   0   0   0   0   0   0   0   0   0   0   0   0   0   0   0   0   0   0   0   0   0   0   0   0   0   0   0   0   0   0   0   0   0   0   0   0   0   0   0   0   0   0   0   0   0   0 165 325 326 327 328 1   0   0   0   0   0   0   0   0   0   0   0   0   0   0   0   0   0   0   0   0   0   0   0   0   0   0   0   0   0   0   0   0   0   0   0   0   0   0   0   0   0   0   0   0   0   0   0   0   0   0   0   0   0   0   0   0   0   0   0   0   0   0 330 331 332 333 334 335 336 337 338   0   0   0   0   0   0   0   0   0   0   0   0   0   0   0   0   0   0   0   0   0   0   0   0   0   0   0   0   0   0   0   0   0   0   0   0   0   0   0   0   0   0   0   0 
  0   0   0   0   0   0   0   0   0   0   0   0   0   0   0   0   0   0   0   0   0   0   0   0   0   0   0   0   0   0   0   0   0   0   0   0   0   0   0   0   0   0   0   0   0   0   0   0   0   0   0   0   0   0   0   0   0   0   0   0   0   0   0   0   0   0   0   0   0   0   0 214 215 408 409 410 411   0   0   0   0   0   0   0   0   0   0   0   0   0   0   0   0   0   0   0   0   0   0   0   0   0   0   0   0   0   0   0   0   0   0   0   0   0   0   0   0   0   0   0   0   0   0   0   0   0   0   0   0   0   0   0   0   0   0   0   0   0   0 349 350 351 352 353 354 355 356 357 358   0   0   0   0   0   0   0   0   0   0   0   0   0   0   0   0   0   0   0   0   0   0   0   0   0   0   0   0   0   0   0   0   0   0   0   0   0   0   0   0   0   0   0 
  0   0   0   0   0   0   0   0   0   0   0 363 364 365 366   0   0   0   0   0   0   0   0   0   0   0   0   0   0   0   0   0   0   0   0   0   0   0   0 363 364 365 366   0   0   0   0   0   0   0   0   0   0   0   0   0   0   0   0   0   0   0   0   0   0   0   0   0   0   0   0 266 267 371 372 373 374   0   0   0   0   0   0   0   0   0   0   0 375 376 377 378   0   0   0   0   0   0   0   0   0   0   0   0   0   0   0   0   0   0   0   0   0   0   0   0   0   0 375 376 377 378   0   0   0   0   0   0   0   0   0   0   0 375 376 377 378   0   0   0 382 383 384 385 386 387 388 389 390   0   0   0   0   0   0   0   0   0   0   0   0   0   0   0   0   0   0   0   0   0   0   0 363 364 365 366   0   0   0   0   0   0   0   0   0   0   0   0   0   0   0   0 
  0   0   0   0   0   0   0   0   0   0   0 397 398 399 400 401 365 366   0   0   0   0   0   0   0   0   0   0   0   0   0   0 403 401 401 365 366   0   0 397 398 399 405   0   0   0   0   0   0   0   0   0   0   0   0   0   0   0   0   0   0   0   0 403 401 401 365 366   0   0   0 1 407 408 409 410 411   0   0   0   0   0   0   0   0 424 425 426 427 398 399 428   0   0   0   0   0   0   0   0   0   0   0 417 418   0   0   0   0   0   0 421 422   0   0   0   0   0 423 398 399 428   0   0   0   0   0   0   0   0 412 413 414 415 398 399 428   0   0   0 430 431 432 433 434 435 436 437 438   0   0   0   0   0 424 425 426 439   0   0   0   0   0   0   0   0   0   0   0 403 401 365 440 398 399 405   0   0   0   0   0   0   0   0   0   0   0   0   0   0   0   0 
470 472 470 471 472 473 474 468 469 470 471 479 461 462 463 464 465 466 467 468 469 467 468 469 470 471 472 473 474 475 476 477 478 464 465 465 466 467 468 479 461 462 466 467 468 469 470 471 472 473 474 475 476 477 469 467 468 469 470 471 472 473 474 478 464 465 465 466 467 468 489 490 491 492 493 494 495   0 496 498 497 498 499 500 501 503 464 465 504 461 462 536 498 499 500 501 502 501 537 500 539 540 541 513 514 515 516 517 518 519 520 521 522 539 540 541 498 500 523 461 462 522 501 502 541 498 499 500 501 502 503 464 465 504 461 462 536 501 502 527 528 529 530 531 532 533 534 535 536 501 502 500 501 502 503 464 465 538 539 540 541 501 502 500 539 540 541 470 471 478 464 465 544 461 462 545 546 547   0   0   0   0   0   0   0   0   0   0   0   0   0   0
